#@###
#...#
###.#
#...#
#x###